[
  {
    "number": 1,
    "name": "まっすぐストリート",
    "square": [
      "O","O","O","O","O","O","O","O","O","O","O","O","O","O","O","O","O","O",
      "O","O","O","O","I","I","I","I","I","I","I","I","I","O","O","O","O","O",
      "O","O","O","O","I","I","I","I","I","I","I","I","I","O","O","O","O","O",
      "O","O","O","O","I","I","I","I","I","I","I","I","I","O","O","O","O","O",
      "O","O","O","O","I","I","I","I","C","I","I","I","I","O","O","O","O","O",
      "O","O","O","O","I","I","I","I","I","I","I","I","I","O","O","O","O","O",
      "O","O","O","O","I","I","I","I","I","I","I","I","I","O","O","O","O","O",
      "O","O","O","O","I","I","I","I","I","I","I","I","I","O","O","O","O","O",
      "O","O","O","O","I","I","I","I","I","I","I","I","I","O","O","O","O","O",
      "O","O","O","O","I","I","I","I","I","I","I","I","I","O","O","O","O","O",
      "O","O","O","O","I","I","I","I","I","I","I","I","I","O","O","O","O","O",
      "O","O","O","O","I","I","I","I","I","I","I","I","I","O","O","O","O","O",
      "O","O","O","O","I","I","I","I","I","I","I","I","I","O","O","O","O","O",
      "O","O","O","O","I","I","I","I","I","I","I","I","I","O","O","O","O","O",
      "O","O","O","O","I","I","I","I","I","I","I","I","I","O","O","O","O","O",
      "O","O","O","O","I","I","I","I","I","I","I","I","I","O","O","O","O","O",
      "O","O","O","O","I","I","I","I","I","I","I","I","I","O","O","O","O","O",
      "O","O","O","O","I","I","I","I","I","I","I","I","I","O","O","O","O","O",
      "O","O","O","O","I","I","I","I","I","I","I","I","I","O","O","O","O","O",
      "O","O","O","O","I","I","I","I","I","I","I","I","I","O","O","O","O","O",
      "O","O","O","O","I","I","I","I","I","I","I","I","I","O","O","O","O","O",
      "O","O","O","O","I","I","I","I","I","I","I","I","I","O","O","O","O","O",
      "O","O","O","O","I","I","I","I","I","I","I","I","I","O","O","O","O","O",
      "O","O","O","O","I","I","I","I","A","I","I","I","I","O","O","O","O","O",
      "O","O","O","O","I","I","I","I","I","I","I","I","I","O","O","O","O","O",
      "O","O","O","O","I","I","I","I","I","I","I","I","I","O","O","O","O","O",
      "O","O","O","O","I","I","I","I","I","I","I","I","I","O","O","O","O","O",
      "O","O","O","O","O","O","O","O","O","O","O","O","O","O","O","O","O","O"
    ]
  }
]
